1000, 1, 0
1500, 1, 0
2000, 2, 0
2500, 2, 0
3000, 3, 0
3500, 3, 0
4000, 3, 0
4500, 1, 0
5000, 2, 0
5500, 0, 1
